00000000000000000000
00000000000000000000
00000000000000000000
00000000000000000000
00000000000000000000
00000000000000000000
00000111111111100000
00000000000000000000
00000000000000000000
00000222222222200000
00000000000000000000
00000000000000000000
00000333333333300000
00000000000000000000
00000000000000000000
