00000000000000000000
01001001000010010010
01001001000010010010
01001001000010010010
01001001222210010010
01001000000000010010
00000011000011000000
01110001000010001110
02220033333333002220
03101001000010010130
03101001111110010130
03101001000010010130
00101001000010010100
00000000000000000000
00000000000000000000
