00000000000000000000
03111002000200000000
03100002000100101000
03101002000100111000
03001003330100121100
03001001001100203220
03330000012000103000
00000000010002103100
02100200033321100000
01300200000000033300
01300100101000102100
01300100101012102100
01300100111000002100
03300000000000011100
00000000000000000000
