00000000000000000000
03300000000000000330
03000000000000000030
03000000000000000030
03000000000000000030
03000000000000000030
03000000000000000030
00000000000000000000
00011100011000111000
00000000000000000000
01000000000000000010
01000000000000000010
01000000000000000010
01000000000000000010
00000000000000000000