00000000000000000000
03300003320000233330
03000003320000233330
03000000320000230030
03000000022002200030
03000000000000000030
03000000000000000030
00000000000000000000
00011100011000111000
00000000000000000000
01000000000000000010
01000000000000000010
01000000000000000010
01000000000000000010
00000000000000000000